abandonnement	abandonment
academie	academy
acetique	acetic
acetylene	acetylene
acide	acid
acidite	acidity
acoustique	acoustic
acoustique	acoustics
acquiescence	acquiescence
acrobate	acrobat
adaptation	adaptation
adhesif	adhesive
adhesion	adhesion
admiration	admiration
admirer	admire
adulation	adulation
adulte	adult
adverbe	adverb
aerobie	aerobic
aerodynamique	aerodynamics
aeronautique	aeronautics
aeroplane	aeroplane
affable	affable
affection	affection
affiliation	affiliation
affluent	affluent
aggression	aggression
agitation	agitation
agoniser	agonize
agronomie	agronomy
aider	aide
aiouez	iowa
alcali	alkali
alcove	alcove
alerte	alert
alexis	alexis
alignement	alignment
allee	allee
allonge	lunge
alpin	alpine
altercation	altercation
amandine	amandine
amasser	amass
amateur	amateur
ambiance	ambiance
ambulance	ambulance
amendement	amendment
amendes	amends
amenite	amenities
amenite	amenity
amiraute	admiralty
amour	amour
amputee	amputee
amunition	ammunition
anaerobie	anaerobic
analyste	analyst
anarchiste	anarchist
anatole	anatole
anatomie	anatomy
animosite	animosity
annette	annette
annexe	annex
annuite	annuity
anthere	anther
antibiotique	antibiotic
antigene	antigen
apache	apache
apathie	apathy
aperitif	aperitif
apologetique	apologetic
apologie	apology
apoplectique	apoplectic
apostrophe	apostrophe
apparent	apparent
apparition	apparition
appointe	appointee
appreciable	appreciable
appreciation	appreciation
apres	apres
apte	apt
arabesque	arabesque
arachnide	arachnid
arbitrage	arbitrage
arbre	arbor
arcade	arcade
architecte	architect
archive	archive
archives	archive
are	are
ariane	ariane
aristocrate	aristocrat
aristocratique	aristocratic
armistice	armistice
armoire	armoire
arrangement	arrangement
arrondissement	arrondissement
artifice	artifice
artique	arctic
artisan	artisan
artiste	artist
artistique	artistic
aspirant	aspirant
assemblage	assemblage
assistant	assistant
assister	assist
asterix	asterix
atelier	atelier
atheiste	atheist
atrophie	atrophy
attache	attache
attachement	attachment
attaque	attack
atteinte	taint
attitude	attitude
audience	audience
auguste	auguste
auteur	auteur
automatique	automatic
automobile	automobile
avenue	avenue
aviateur	aviator
aviation	aviation
baccalaureat	baccalaureate
bagatelle	bagatelle
baies	bays
baillier	bail
ballet	ballet
ballon	ballon
balustrade	balustrade
banalite	banality
barde	bard
barrage	barrage
barrette	barrette
barrette	barret
basque	basque
basson	bassoon
bastide	bastide
bastille	bastille
bat	bat
bateau	bateau
batiste	batiste
baton	baton
belle	belle
bercelonette	bassinet
beret	beret
bernadette	bernadette
besancon	besancon
bichon	bichon
bidet	bidet
bigot	bigot
bigoterie	bigotry
bijou	bijou
bikini	bikini
billion	billion
biopsie	biopsy
bis	bice
bivouac	bivouac
bizarre	bizarre
blague	blag
blase	blase
bloc	bloc
bobine	bobbin
bohemien	bohemian
bombe	bomb
bordeaux	bordeaux
borne	bourn
boudoir	boudoir
bouger	budge
bougre	bugger
boulanger	boulanger
boule	boule
boulevard	boulevard
bourgeois	bourgeoisie
bourgeoise	bourgeoise
bourse	bourse
boutique	boutique
brasier	brazier
brasser	brasserie
bravade	bravado
brave	brave
breton	breton
bride	bride
brillant	brilliant
brique	brick
brouhaha	brouhaha
brunoise	brunoise
brusque	brusque
bruyere	briar
bulletin	bulletin
bureaucrate	bureaucrat
burlesque	burlesque
busart	buzzard
buste	bust
cabestan	capstan
cabriolet	cabriolet
cache	cache
cachet	cachet
cacophonie	cacophony
cadence	cadence
cadet	cadet
cadre	cadre
cafeine	caffeine
caissier	cashier
caisson	caisson
cajoler	cajole
calamine	calamine
calibre	calibre
camargue	camargue
camille	camille
campagne	campaign
canard	canard
cantine	canteen
cantonnement	cantonment
capitalisme	capitalism
caprice	caprice
capricieux	capricious
capsule	capsule
carabine	carbine
carapace	carapace
carbonate	carbonate
carde	chard
cardinal	cardinal
caricature	caricature
carmin	carmine
carotte	carrot
carrousel	carrousel
cartel	cartel
cartilage	cartilage
cartographie	cartography
carton	carton
carvi	caraway
cascade	cascade
casser	cass
casserole	casserole
cassette	cassette
cassis	cassis
cataclysme	cataclysm
catacombe	catacomb
catherine	catherine
caviar	caviar
celeri	celery
celeste	celeste
celine	celine
centre	center
cepe	cep
cereale	cereal
cerebral	cerebral
chagrin	chagrin
chaise	chaise
cham	cham
chambre	chamber
chamois	chamois
champagne	champagne
chancellerie	chancery
chantier	gantry
chaperon	chaperon
charade	charade
charlemagne	charlemagne
charlotte	charlotte
charnel	charnel
chassis	chassis
chauffeur	chauffeur
chauvinisme	chauvinism
chevron	chevron
chicanerie	chicanery
chichi	chichi
chloroforme	chloroform
chopine	chopin
choregraphie	choreography
christine	christine
chute	chute
ciel	ceil
cierge	serge
cigarette	cigarette
cinema	cinema
cirque	cirque
citadelle	citadel
citer	cite
civiliser	civilize
clairvoyance	clairvoyance
clairvoyant	clairvoyant
clandestin	clandestine
clapier	clapper
clarifier	clarify
classe	class
classification	classification
classifier	classify
classique	classic
clementine	clementine
cliche	cliche
clientele	clientele
climat	climate
clique	clique
cloche	cloche
clos	close
coalition	coalition
cocon	cocoon
code	code
cognac	cognac
cohabitation	cohabitation
cohesion	cohesion
coincider	coincide
coler	coll
collaborateur	collaborator
cologne	cologne
colonnade	colonnade
colossal	colossal
comedienne	comedienne
commencement	commencement
commerce	commerce
commode	commode
commune	commune
communique	communique
commutation	commutation
compaction	compaction
complexe	complex
complicite	complicity
compote	compote
concentrer	concentrate
concierge	concierge
concordat	concordat
console	console
consoler	console
consultant	consultant
contraster	contrast
contusion	contusion
convalescence	convalescence
conversation	conversation
coquette	coquette
cordon	cordon
coriandre	coriander
corps	corps
corruption	corruption
cortege	cortege
corvette	corvette
costume	costume
cotelette	cutlet
coulee	coulee
coupon	coupon
courante	courant
courtisane	courtesan
couturier	couturier
cravate	cravat
crayon	crayon
creation	creation
credulite	credulity
creme	creme
crepe	crepe
crepe	crepe
cretin	cretin
crevasse	crevasse
critique	critique
crochet	crochet
croissant	croissant
croquer	croquette
cubisme	cubism
culte	cult
date	date
datte	date
dauphin	dauphin
debacle	debacle
debris	debris
debut	debut
decadence	decadence
decapiter	decapitate
declarer	declare
decor	decor
decor	decor
deficit	deficit
democrate	democrat
denise	denise
dentiste	dentist
departement	department
deplacement	displacement
deployer	deploy
depot	depot
depute	deputy
derriere	derriere
desastreux	disastrous
desorganiser	disorganization
dessert	dessert
destitution	destitution
detachement	detachment
detail	detail
detente	detente
detonation	detonation
detour	detour
deux	deuce
developper	develop
devotee	devotee
dey	dey
diable	diablo
dime	dime
diphtongue	diphthong
diplomate	diplomat
diplomatie	diplomacy
discotheque	discotheque
discussion	discussion
disperser	disperse
district	district
diversion	diversion
doctrinal	doctrinal
dogmatique	dogmatic
dolomite	dolomite
domino	domino
dose	dose
douche	douche
douer	dow
douzaine	dozen
drole	droll
duvet	duvet
dynamique	dynamic
echelon	echelon
eclair	eclair
effigie	effigy
ellipse	ellipse
eloise	eloise
embarrasser	embarrass
embouchure	embouchure
emeri	emery
emigre	emigre
emotion	emotion
empecher	impeach
empereor	emperor
emplacement	emplacement
employe	employee
employeur	employer
enchanter	enchant
enclave	enclave
encore	encore
engagement	engagement
ensemble	ensemble
enterrer	inter
entomologie	entomology
entree	entree
entrepreneur	entrepreneur
envisager	envisage
epidemique	epidemic
epilogue	epilogue
episode	episode
equiper	equip
equitable	equitable
erg	erg
erotique	erotic
escadrille	escadrille
escadron	squadron
escapade	escapade
escarpement	escarpment
essence	essence
estile	style
estragon	estragon
et	et
etincelle	tinsel
etoile	etoile
eucalyptus	eucalyptus
europeen	european
exaltation	exaltation
exemplaire	exemplar
expertise	expertise
exploitation	exploitation
expose	expose
extinction	extinction
facade	facade
facade	facade
facetieux	facetious
falsifier	falsify
famine	famine
fatiguer	fatigue
faubourg	faubourg
faux	faux
federal	federal
federation	federation
feint	feint
festre	fester
fete	fete
fetiche	fetish
feuille	foil
fiance	fiance
fibre	fibre
fibre	fiber
file	file
fils	fils
financier	financier
flambeau	flambeau
flamboyant	flamboyant
flandres	flanders
fleur	fleur
florence	florence
florentin	florentine
fonderie	foundry
fondue	fondue
formation	formation
fort	forte
foulis	foil
foyer	foyer
fracas	fracas
fractal	fractal
franc	frank
francais	francais
france	france
furtif	furtive
fuselage	fuselage
gabelle	gabelle
gabrielle	gabrielle
gaffe	gaffe
gaiete	gaiety
garage	garage
gastronomie	gastronomy
gauche	gauche
gaule	gaul
gaze	gauze
gazelle	gazelle
gelatine	gelatin
genevieve	genevieve
genie	genie
gerbille	gerbil
gibbon	gibbon
giraffe	giraffe
giselle	giselle
glacial	glacial
glacier	glacier
gluten	gluten
glycerine	glycerin
gnome	gnome
golfe	gulf
grade	grade
grandiose	grandiose
granit	granite
gratin	gratin
gratitude	gratitude
grave	grave
grenade	grenade
grenadier	grenadier
grenadine	grenadine
grenoble	grenoble
groupe	group
guidon	guidon
guillotine	guillotine
habiter	habitation
hacher	hash
hachette	hatchet
haha	haha
hangar	hangar
hectare	hectare
helicoptere	helicopter
heritage	heritage
heroisme	heroism
historien	historian
hombre	ombre
hospice	hospice
hospitalite	hospitality
hotel	hotel
hotelier	hotelier
huguenot	huguenot
humide	humid
hut	hutter
hutte	hut
hydrate	hydrate
hydrogene	hydrogen
hygiene	hygiene
hyoide	hyoid
hypnotique	hypnotic
iambe	iamb
ideal	ideal
idealiste	idealist
identifier	identify
ideologie	ideology
ideologue	ideologue
ignominie	ignominy
ignorer	ignore
impasse	impasse
impersonnel	impersonal
implantation	implantation
implorer	implore
impossible	impossible
impressionisme	impressionism
impressionniste	impressionist
improvisation	improvisation
inaugurer	inaugural
inaugurer	inaugurate
incompatible	incompatible
incontinence	incontinence
indecision	indecision
indulgence	indulgence
inepte	inept
inerte	inert
inestimable	inestimable
inexperience	inexperience
initiative	initiative
injustice	injustice
innocence	innocence
instance	instance
inventaire	inventory
investir	invest
iode	iodine
irascible	irascible
irene	irene
jacobin	jacobin
jasmin	jasmine
jeanne	jeanne
jet	jet
josephine	josephine
journalisme	journalism
jovial	jovial
jube	jube
justine	justine
juxtaposition	juxtaposition
kepi	kepi
kilogramme	kilogram
kilometre	kilometre
kiosque	kiosk
kir	kir
la	la
lacre	lacquer
lampon	lampoon
languedoc	languedoc
latitude	latitude
le	le
leger	leger
legionnaire	legionnaire
levant	levant
lever	lever
liaison	liaison
liberation	liberation
lieu	lieu
limousine	limousine
lingerie	lingerie
liqueur	liqueur
litteraire	literary
livre	livre
lobe	lobe
local	locale
loge	loge
looch	loch
loquet	locket
loris	loris
louise	louise
lucille	lucille
lucratif	lucrative
lune	lune
luxe	luxe
luxurieux	luxurious
luzerne	lucerne
lycee	lycee
lyrique	lyric
macabre	macabre
macaque	macaque
machinerie	machinery
machiniste	machinist
maconnerie	masonry
madagascar	madagascar
madeleine	madeleine
mai	may
mail	mall
maillot	maillot
maistrie	mastery
major	major
mal	mal
mandarine	mandarin
mandoline	mandolin
manganese	manganese
manque	manque
manteuil	mantua
maquis	maquis
marc	marc
marechal	marechal
marge	marge
margot	margot
marguerite	marguerite
marianne	marianne
marionnette	marionette
marmelade	marmalade
marmite	marmite
marquise	marquise
marrakech	marrakech
marron	maroon
marseille	marseilles
mascarade	masquerade
mascotte	mascot
massage	massage
masseur	masseur
masseuse	masseuse
massif	massive
materiel	materiel
matinee	matinee
mauve	mauve
mayonnaise	mayonnaise
melange	melange
melanie	melanie
melodrame	melodrama
memoire	memoir
menagerie	menagerie
mentor	mentor
menu	menu
menuet	minuet
meringue	meringue
merle	merle
merovingien	merovingian
metre	metre
metre	meter
metrique	metric
metro	metro
meuse	meuse
microcosme	microcosm
micrometre	micrometer
mignon	mignon
milieu	milieu
militaire	military
milligramme	milligram
millionnaire	millionaire
mine	mien
minuscule	minuscule
mise	mise
mission	mission
mistral	mistral
mode	mode
module	module
monocle	monocle
monolithe	monolith
monseigneur	monseigneur
montage	montage
moraine	moraine
moral	moral
moral	morale
morgue	morgue
morpheme	morpheme
moselle	moselle
mosquee	mosque
mot	mot
moulin	moulin
mousquet	musket
mousse	mousse
mousseline	muslin
multiple	multiple
municipal	municipal
muscat	muscat
muscle	muscle
myriade	myriad
mystique	mystique
naive	naive
nantes	nantes
napoleon	napoleon
natron	natron
negociation	negotiation
nicotine	nicotine
nimphe	nymph
nocturne	nocturne
nonchalant	nonchalant
normatif	normative
nougat	nougat
nubile	nubile
numerique	numeric
obelix	obelix
obesite	obesity
obscur	obscure
observer	observe
oceanie	oceania
oeuvre	oeuvre
oligarchie	oligarchy
omelette	omelette
once	ounce
opacite	opacity
opter	opt
orange	orange
oriole	oriole
orthopedique	orthopedic
outchibouec	ojibwe
oxygene	oxygen
pacifisme	pacifism
palette	palette
palissade	palisade
panda	panda
pantographe	pantograph
par	par
parachute	parachute
parade	parade
paradis	paradise
parametre	parameter
parasol	parasol
parfait	parfait
parisienne	parisienne
parite	parity
parmesan	parmesan
parti	parti
partisan	partisan
passable	passable
passager	passage
passeport	passport
passif	passive
patrouille	patrol
patrouiller	patrol
pauline	pauline
pedale	pedal
peluche	plush
pensif	pensive
perception	perception
perche	perch
pere	pere
periodique	periodic
perle	pearl
persecuter	persecute
personnel	personnel
petite	petite
physiologie	physiology
physique	physique
pianiste	pianist
pic	pique
pierrot	pierrot
pignon	pinion
pile	pile
pineal	pineal
pipette	pipette
pique	pique
pique-nique	picnic
piquet	piquet
piquet	picket
pirouette	pirouette
piston	piston
plaintif	plaintive
plan	plan
plateau	plateau
pointe	pointe
polemique	polemic
policie	policy
politie	polity
pommade	pomade
ponce	pounce
portable	portable
portemanteau	portmanteau
position	position
positivisme	positivism
potee	putty
pouf	pouf
poule	pool
pragmatique	pragmatic
prairie	prairie
praline	praline
praticable	practicable
precaution	precaution
predilection	predilection
prehensile	prehensile
prehistorique	prehistoric
president	president
pretensse	pretence
pretentieux	pretentious
pretexte	pretext
prime	prime
priorite	priority
probable	probable
probation	probation
prodigieux	prodigious
profil	profile
proletariat	proletariat
promenade	promenade
promotion	promotion
prompt	prompt
proprietaire	proprietary
prosaique	prosaic
provenance	provenance
provence	provence
provocateur	provo
prude	prude
psychologie	psychology
publiciste	publicist
publicite	publicity
purer	puree
pyramide	pyramid
quadrillion	quadrillion
quart	quart
quebecois	quebecois
questionnaire	questionnaire
quine	keno
racisme	racism
radical	radical
ragout	ragout
railler	rally
rale	rail
rameau	rameau
rampe	ramp
rappeler	rappel
ratatouille	ratatouille
ration	ration
rationalite	rationality
reactionnaire	reactionary
rebus	rebus
reconnaissance	reconnaissance
record	record
recreation	recreation
redoutable	redoubtable
redoute	redoubt
refrain	refrain
refugie	refugee
refuser	refuse
regale	regale
regaler	regale
regime	regime
reins	reins
remarquable	remarkable
rempart	rampart
renaissance	renaissance
renard	reynard
renee	renee
repartie	repartee
repentir	repent
repertoire	repertoire
reportage	reportage
reprimande	reprimand
republique	republic
reseda	reseda
reservoir	reservoir
resistance	resistance
resistant	resistant
responsable	responsible
ressentiment	resentment
resume	resume
retenir	retain
reveillez	reveille
reveler	reveal
revue	revue
revulsion	revulsion
ricochet	ricochet
risque	risque
role	role
roquette	rocket
rose	rose
rose	rose
rose	rose
rosette	rosette
rouge	rouge
routine	routine
rupture	rupture
sabot	sabot
sabotage	sabotage
saboteur	saboteur
sabre	sabre
sac	sac
sacristian	sacristan
saillie	sally
salle	salle
salon	salon
salon	saloon
sanction	sanction
sanguin	sanguine
saper	sap
sarcophage	sarcophagus
sardonique	sardonic
satyre	satyr
sauciere	saucer
saute	saute
savant	savant
saxophone	saxophone
scaramouche	scaramouche
scetie	settee
seance	seance
secretariat	secretariat
seine	seine
selle	sell
semite	semite
sentence	sentence
sentiment	sentiment
sequin	sequin
serenade	serenade
serge	serge
signature	signature
silhouette	silhouette
simone	simone
situation	situation
sociologie	sociology
soiree	soiree
soiree	soiree
solde	sold
solicitation	solicitation
solidarite	solidarity
solidifier	solidify
somatique	somatic
sombre	somber
somptueux	sumptuous
sorbet	sorbet
sortie	sortie
souvenir	souvenir
spectre	specter
spire	spire
stagnant	stagnant
stephanie	stephanie
structure	structure
subsister	subsist
suite	suite
surete	surete
surplus	surplus
surveillance	surveillance
suzanne	suzanne
svelte	svelte
symptomatique	symptomatic
syndicat	syndicate
syrah	syrah
tableau	tableau
tactile	tactile
taffetas	taffeta
tailleur	tailor
talus	talus
tambourin	tambourine
tamis	tammy
tapir	tapir
tare	tare
tarot	tarot
tartane	tartan
tartare	tartare
taupe	taupe
taxonomie	taxonomy
technique	technique
telecommunication	telecommunication
television	television
terminal	terminal
terne	tern
terrain	terrain
terrasse	terrace
terroriste	terrorist
testimonial	testimonial
texture	texture
theatre	theatre
thermometre	thermometer
tiburon	tiburon
timide	timid
toge	toge
tourniquet	tourniquet
toxicologie	toxicology
toxique	toxic
trafic	traffic
tranche	tranche
trapeze	trapeze
trappiste	trappist
travers	travers
travestir	travesty
triage	triage
trimestre	trimester
trombe	tromp
troposphere	troposphere
trousseau	trousseau
tuffe	tuff
tuileries	tuileries
tutu	tutu
typographie	typography
unique	unique
usuel	usual
usurper	usurp
utiliser	utilise
vacation	vacation
vallee	valley
variable	variable
variete	variety
velodrome	velodrome
velours	velour
venal	venal
ventricule	ventricle
verbiage	verbiage
veritable	veritable
vermeil	vermeil
vermeil	vermilion
vermout	vermouth
vernis	varnish
verve	verve
veste	vest
vibrant	vibrant
vibration	vibration
vientiane	vientiane
village	village
violation	violation
vis	vise
vis	vice
vitalite	vitality
voila	voila
volcanique	volcanic
volition	volition
voyeur	voyeur
wallon	walloon
zero	zero
zeste	zest
